%%%%%%%%%
%.. % G %
%%% %%%%%
%       %
%%%%%%% %
%       %
% %%%%% %
%     % %
%%%%% % %
%     %o%%%%%%%%%%%%%%%%%%%%
% %%%%%%%                  %
%      .                   %
%%%%%%%.%%%%%%%%%%%%%%%%%%%%
%Po    .%
%%%%%%%%%